TITLE
xxxxxxxxxxxxxxxxxxxxxxxxxxxxxxxxxxxxxxxx
x                                      x
x                                      x
x                                      x
x                                      x
x                                      x
x                                      x
x                                      x
x                                      x
x                                      x
x                                      x
x                                      x
x                                      x
x                                      x
x                                      x
x                                      x
x                                      x
x                                      x
x                                      x
x                                      x
x                                      x
x                                      x
x                                      x
x                                      x
xxxxxxxxxxxxxxxxxxxxxxxxxxxxxxxxxxxxxxxx
z
TITLE 2
........................................
..................x.....................
..................x.....................
..................x.....................
..................x.....................
..................x.....................
..................x.....................
..................x.....................
..................x.....................
..................x.....................
..................x.....................
..................x.....................
..................x.....................
..................x.....................
..................x.....................
..................x.....................
..................x.....................
..................x.....................
..................x.....................
..................x.....................
..................x.....................
..................x.....................
..................x.....................
..................x.....................
........................................
z
Z

