DUMMY
........................................
........................................
........................................
........................................
........................................
........................................
........................................
........................................
........................................
........................................
........................................
........................................
........................................
........................................
........................................
........................................
........................................
........................................
........................................
........................................
f..................f...................f
........................................
........................................
........................................
z
CURIOSITY
........................................
..................fff...................
..................fxf...................
..................fff...................
........................................
........................................
........................................
........................................
........................................
........................................
........................................
........................................
........................................
........................................
........................................
........................................
........................................
........................................
........................................
........................................
........................................
........................................
........................................
........................................
z
TRAINING
xxxxxxxxxxxxxxxxxxxxxxxxxxxxxxxxxxxxxxxx
x                                      x
x                                      x
x                                      x
x                                      x
x                                      x
x                                      x
x                                      x
..................fff...................
........................................
........................................
........................................
........................................
........................................
........................................
........................................
x                                      x
x                                      x
x                                      x
x                                      x
x                                      x
x                                      x
x                                      x
xxxxxxxxxxxxxxxxxxxxxxxxxxxxxxxxxxxxxxxx
z
HOLD THE LINE
........................................
..................x.....................
..................x.....................
..................x.....................
..................x.....................
..................x.....................
..................x.....................
..................x.....................
..................x.....................
..................x.....................
..................x.....................
..................x.....................
..................x........f............
..................x.....................
..................x.....................
..................x.....................
..................x.....................
..................x.....................
..................x.....................
..................x.....................
..................x.....................
..................x.....................
..................x.....................
........................................
z
CLOSED
xxxxxxxxxxxxxxxxxxxxxxxxxxxxxxxxxxxxxxxx
x                                      x
x                                      x
x                                      x
xffffffffffffffffffffffffffffffffffffffx
x                                      x
x                                      x
x                                      x
x                                      x
x                                      x
x                                      x
x                                      x
x                                      x
x                                      x
x                                      x
x                                      x
x                                      x
x                                      x
x                                      x
x                                      x
x                                      x
x                                      x
x                                      x
xxxxxxxxxxxxxxxxxxxxxxxxxxxxxxxxxxxxxxxx
z
SNAKE
........................................
........................................
xxxxxxxxxxxxxxxxxxxxxxxxxxxxxxxx........
........................................
...................fff..................
........................................
........................................
........xxxxxxxxxxxxxxxxxxxxxxxxxxxxxxxx
........................................
........................................
........................................
........................................
xxxxxxxxxxxxxxxxxxxxxxxxxxxxxxxx........
........................................
........................................
........................................
........................................
........xxxxxxxxxxxxxxxxxxxxxxxxxxxxxxxx
........................................
........................................
........................................
........................................
xxxxxxxxxxxxxxxxxxxxxxxxxxxxxxxx........
........................................
z
Z

